48 9
0 0 1 2 1 2 1 2 1 2 1 2 0 0 0 0 0 0 1 2 1 2 1 2 1 2 1 2 0 0 0 0 0 0 0 0 0 0 0 0 3 4 5 6 5 6 7 8
32 33 32 33 32 33 32 33 32 33 32 33 0 0 0 0 32 33 32 33 32 33 32 33 32 33 32 33 0 0 0 0 0 0 0 0 0 0 0 0 8 8 4 34 4 34 35 8
56 57 56 57 56 57 56 57 56 57 56 57 1 2 1 2 56 57 56 57 56 57 56 57 56 57 56 57 1 2 1 2 1 2 1 2 1 2 1 2 8 58 59 34 59 34 60 8
32 33 67 68 32 33 32 33 32 33 32 33 32 33 32 33 32 33 67 68 32 33 32 33 32 33 32 33 32 33 32 33 32 33 32 33 67 68 67 68 8 4 69 70 4 34 71 8
56 57 87 88 56 57 56 57 56 57 56 57 56 57 56 57 56 57 87 88 56 57 56 57 56 57 56 57 56 57 56 57 56 57 56 57 87 88 87 88 8 89 90 8 59 34 7 8
67 68 8 8 67 68 67 68 67 68 67 68 67 68 67 68 67 68 8 8 67 68 67 68 67 68 67 68 67 68 67 68 67 68 67 68 8 8 8 8 8 4 71 8 4 34 35 8
87 88 107 108 87 88 87 88 87 88 87 88 87 88 87 88 87 88 107 108 87 88 87 88 87 88 87 88 87 88 87 88 87 88 87 88 107 108 8 8 8 89 7 8 59 34 60 8
114 115 116 117 8 8 114 115 114 115 8 8 114 115 8 8 114 115 116 117 8 8 114 115 114 115 8 8 114 115 8 8 8 8 8 8 116 117 8 8 8 89 118 8 89 119 35 8
120 121 122 123 80 80 120 121 120 121 80 80 120 121 80 80 120 121 122 123 80 80 120 121 120 121 80 80 120 121 80 80 80 80 124 76 122 123 77 125 126 49 127 8 127 128 60 8