55  10
23 23 23 23 23 8 8 9 10 9 10 11 12 20 21 9 10 11 12 17 18 9 10 11 12 13 14 26 27 28 29 9 10 30 31 11 12 28 29 9 10 30 31 11 12 28 29 9 10 15 16 17 18 22 8
23 48 23 48 23 23 8 42 43 36 37 11 12 42 43 42 43 11 12 19 19 42 43 11 12 38 39 36 37 42 43 49 50 51 52 11 12 53 54 49 50 51 52 11 12 53 54 49 50 15 44 19 19 55 8
23 23 23 23 23 23 8 9 10 20 21 11 12 9 10 9 10 11 12 19 19 9 10 11 12 61 62 20 21 9 10 11 12 30 31 11 12 28 29 11 12 30 31 11 12 28 29 11 12 13 14 19 19 22 8
47 23 23 23 23 23 8 78 79 80 80 80 80 81 82 83 84 11 12 19 19 42 43 11 12 45 46 42 43 42 43 11 12 42 43 11 12 42 43 11 12 42 43 11 12 40 41 11 12 45 46 19 19 23 8
66 8 8 8 8 8 8 8 8 8 8 8 8 8 93 94 95 11 12 19 19 9 10 11 12 63 64 9 10 9 10 11 12 9 10 11 12 9 10 11 12 9 10 11 12 17 18 11 12 63 64 19 19 23 8
104 23 23 23 47 105 106 15 44 42 43 49 50 100 101 93 102 80 80 78 79 80 80 80 80 81 82 83 84 42 43 11 12 42 43 11 12 42 43 11 12 42 43 11 12 36 37 11 12 72 73 74 75 23 8
8 112 113 65 66 105 106 13 14 9 10 11 12 26 27 8 8 8 8 8 8 8 8 8 8 8 93 94 95 9 10 11 12 9 10 11 12 9 10 11 12 9 10 11 12 20 21 11 12 91 74 92 8 8 8
12 93 104 23 23 105 106 45 46 42 43 11 12 42 43 40 41 11 12 36 37 11 12 36 37 100 101 93 94 83 84 11 12 42 43 11 12 42 43 11 12 42 43 11 12 42 43 11 12 97 92 98 99 55 8
12 129 93 112 113 105 106 63 64 9 10 11 12 9 10 17 18 11 12 20 21 11 12 20 21 26 27 130 93 94 95 11 12 9 10 11 12 9 10 11 12 9 10 11 12 9 10 11 12 8 8 109 110 22 8
77 23 132 93 133 134 106 78 79 78 79 76 77 78 79 78 79 76 77 78 79 76 77 78 79 78 79 78 79 93 102 76 77 78 79 76 77 78 79 76 77 78 79 76 77 78 79 76 77 78 79 78 79 131 8