112  10
9 10 11 12 13 14 9 10 9 10 11 12 13 14 9 10 9 10 11 12 15 16 9 10 9 10 11 12 13 14 9 10 17 18 11 12 13 14 17 18 9 10 9 10 9 10 9 10 11 12 13 14 19 19 11 12 20 21 9 10 9 10 17 18 11 12 17 18 11 12 17 18 11 12 17 18 11 12 9 10 17 18 9 10 20 21 20 21 9 10 19 19 11 12 22 8 8 23 23 23 23 23 11 12 23 23 23 23 23 23 23 23
36 37 11 12 38 39 40 41 42 43 11 12 38 39 40 41 42 43 11 12 15 44 40 41 42 43 11 12 38 39 40 41 36 37 11 12 38 39 19 19 42 43 42 43 42 43 42 43 11 12 45 46 19 19 11 12 42 43 42 43 42 43 36 37 11 12 19 19 11 12 19 19 11 12 19 19 11 12 42 43 19 19 42 43 42 43 42 43 42 43 19 19 11 12 23 8 8 23 23 47 23 23 11 25 23 23 48 23 48 23 48 23
20 21 11 12 61 62 17 18 9 10 11 12 61 62 17 18 9 10 11 12 13 14 17 18 9 10 11 12 61 62 17 18 20 21 11 12 61 62 19 19 9 10 9 10 9 10 9 10 11 12 63 64 19 19 11 12 9 10 9 10 9 10 20 21 11 12 19 19 11 12 19 19 11 12 19 19 11 12 9 10 19 19 9 10 9 10 9 10 9 10 19 19 11 12 23 8 8 23 65 66 23 23 24 25 23 23 23 23 23 23 23 23 
42 43 11 12 45 46 19 19 42 43 11 12 38 39 19 19 42 43 11 12 38 39 19 19 42 43 11 12 38 39 19 19 42 43 11 12 38 39 19 19 42 43 42 43 72 73 74 75 76 77 78 79 80 80 80 80 81 82 83 84 42 43 42 43 11 12 19 19 11 12 19 19 11 12 19 19 11 12 40 41 19 19 42 43 72 73 74 75 80 80 78 79 76 77 23 8 8 23 23 23 23 23 76 77 23 23 23 23 85 86 85 86 
9 10 11 12 63 64 19 19 9 10 11 12 61 62 19 19 9 10 11 12 61 62 19 19 9 10 11 12 61 62 19 19 9 10 11 12 61 62 19 19 9 10 9 10 91 74 92 8 8 8 8 8 8 8 8 8 8 93 94 95 9 10 9 10 11 12 19 19 11 12 19 19 11 12 19 19 11 12 17 18 19 19 9 10 91 74 92 8 8 8 8 8 8 8 8 8 8 8 8 8 8 8 8 8 23 23 23 23 8 96 8 96 
42 43 11 12 42 43 19 19 42 43 11 12 45 46 19 19 40 41 11 12 38 39 19 19 42 43 11 12 45 46 19 19 42 43 11 12 38 39 19 19 72 73 74 75 97 92 98 99 11 12 42 43 36 37 11 12 100 101 93 102 78 79 80 80 11 12 19 19 11 12 19 19 11 12 19 19 11 12 36 37 19 19 72 73 103 92 98 99 42 43 42 43 49 50 55 8 8 23 85 86 85 86 11 12 23 23 80 104 23 23 85 86
9 10 11 12 9 10 19 19 9 10 11 12 63 64 19 19 17 18 11 12 61 62 19 19 9 10 11 12 63 64 19 19 9 10 11 12 61 62 19 19 91 74 92 8 8 8 109 110 11 12 9 10 20 21 11 12 26 27 8 8 8 8 8 8 11 12 19 19 11 12 19 19 11 12 19 19 11 12 20 21 19 19 91 74 92 111 109 110 9 10 9 10 11 12 22 8 8 23 8 96 8 96 11 12 8 8 8 8 112 113 8 96
42 43 11 12 42 43 19 19 40 41 11 12 42 43 19 19 36 37 11 12 45 46 19 19 42 43 11 12 42 43 19 19 36 37 11 12 45 46 72 73 103 92 98 99 40 41 42 43 11 12 42 43 42 43 11 12 42 43 11 12 40 41 40 41 11 12 19 19 11 12 19 19 11 12 19 19 11 12 40 41 72 73 103 92 98 99 40 41 42 43 42 43 11 12 55 8 8 23 23 23 23 23 11 25 85 86 11 12 93 104 23 23
9 10 11 12 9 10 19 19 17 18 11 12 9 10 19 19 20 21 11 12 63 64 19 19 9 10 11 12 9 10 19 19 20 21 11 12 63 64 91 74 92 111 109 110 17 18 9 10 11 12 9 10 9 10 11 12 9 10 11 12 17 18 17 18 11 12 19 19 11 12 19 19 11 12 19 19 11 12 17 18 91 74 92 111 109 110 17 18 9 10 9 10 11 12 22 8 8 23 23 23 23 23 24 25 8 96 11 12 129 93 112 113
78 79 76 77 78 79 78 79 78 79 76 77 78 79 78 79 78 79 76 77 78 79 78 79 78 79 76 77 78 79 78 79 78 79 76 77 78 79 97 92 78 79 78 79 78 79 78 79 76 77 78 79 78 79 76 77 78 79 76 77 78 79 78 79 76 77 78 79 76 77 78 79 76 77 78 79 76 77 78 79 97 92 78 79 78 79 78 79 78 79 78 79 76 77 131 8 8 23 80 104 23 23 76 77 23 23 76 77 23 132 93 133