62 12
0 1 2 2 0 1 2 2 3 3 4 3 3 3 2 2 2 2 0 1 5 6 0 1 3 3 0 1 5 6 0 1 7 8 3 3 3 3 9 10 3 3 0 1 5 6 0 1 3 3 0 1 3 3 0 1 3 3 0 1 5 6
0 1 2 2 0 1 2 2 11 4 7 8 12 13 2 2 2 2 0 1 3 3 0 1 14 15 0 1 3 3 0 1 16 17 3 3 3 3 3 3 14 15 0 1 16 17 0 1 3 3 0 1 3 3 0 1 14 15 0 1 18 19
2 2 2 2 2 2 2 2 2 2 2 2 2 2 2 2 2 2 0 1 3 3 0 1 5 6 0 1 3 3 0 1 9 10 3 3 3 3 3 3 5 6 0 1 9 10 0 1 3 3 0 1 3 3 2 2 5 6 0 1 7 8
20 21 22 23 20 21 22 23 0 1 3 3 3 3 16 17 2 19 0 1 12 13 0 1 12 13 0 1 12 13 0 1 3 3 3 3 14 15 12 13 3 3 0 1 18 19 0 1 12 13 0 1 14 15 0 1 12 13 0 1 7 8
0 1 2 2 0 1 2 2 0 1 3 3 3 3 9 10 2 24 0 1 2 2 2 2 2 2 2 2 2 2 2 2 3 3 3 3 5 6 2 2 3 3 0 1 7 8 2 2 2 2 2 2 5 6 0 1 2 2 2 2 2 2
0 1 25 25 0 1 25 25 0 1 3 3 7 8 12 13 2 26 0 1 16 17 20 21 22 23 20 21 22 23 20 21 3 3 3 3 3 3 20 21 18 19 27 28 22 23 20 21 22 23 0 1 7 8 27 28 22 23 20 21 22 23
0 1 25 25 0 1 25 25 0 1 3 3 2 2 2 2 2 2 2 2 9 10 0 1 2 2 0 1 2 2 0 1 3 3 3 3 3 3 0 1 7 8 0 1 2 2 0 1 2 2 0 1 2 2 0 1 2 2 0 1 2 2
0 1 25 25 0 1 25 25 0 1 2 2 2 2 2 2 2 2 27 28 14 15 0 1 3 3 0 1 3 3 0 1 7 8 14 15 12 13 0 1 29 30 0 1 7 8 0 1 12 13 0 1 12 13 0 1 12 13 0 1 12 13
0 1 25 25 0 1 25 25 0 1 2 2 2 2 2 2 2 2 0 1 5 6 0 1 3 3 0 1 3 3 2 2 2 31 5 6 2 2 2 2 32 33 2 2 2 2 2 2 2 2 2 2 2 2 2 2 2 2 2 2 2 2
0 1 25 34 0 1 25 34 0 1 2 2 2 2 2 2 2 2 0 1 11 4 2 2 16 17 2 2 22 23 20 21 22 23 2 2 22 23 20 21 2 2 20 21 22 23 20 21 22 23 20 21 22 23 20 21 22 23 20 21 22 23
2 2 2 2 2 2 2 2 2 2 2 2 2 2 2 2 2 2 0 1 4 3 27 35 9 10 27 35 2 2 0 1 2 2 2 2 2 2 0 1 2 2 0 1 2 2 0 1 2 2 0 1 2 2 0 1 2 2 0 1 2 2
2 2 2 2 2 2 2 2 2 2 2 2 2 2 2 2 2 2 2 2 2 2 2 2 2 2 2 2 2 2 2 2 2 2 2 2 2 2 2 2 2 2 2 2 2 2 2 2 2 2 2 2 2 2 2 2 2 2 2 2 2 2