48 11
0 0 1 2 3 4 1 2 4 4 1 2 4 4 1 2 4 4 1 2 4 4 4 4 4 4 1 2 5 6 1 2 4 4 1 2 4 4 1 2 4 4 1 2 4 4 1 2
0 0 1 7 4 4 1 2 4 4 1 2 8 9 1 2 4 4 1 2 4 4 4 4 10 11 1 2 4 4 1 2 4 4 1 2 4 4 1 2 4 4 1 2 4 4 1 2
0 0 0 0 4 4 1 2 4 4 1 2 12 13 1 2 4 4 0 14 4 4 4 4 5 6 1 2 4 4 1 2 4 4 1 2 4 4 1 2 4 4 1 2 4 4 1 2
0 0 1 2 15 16 1 2 15 16 1 2 12 13 1 2 15 16 1 2 15 16 12 13 12 13 1 2 15 16 1 2 15 16 1 2 12 13 1 2 12 13 1 2 15 16 1 2
0 0 0 0 0 0 0 0 0 0 0 0 0 0 0 0 0 0 1 2 0 0 0 0 0 0 0 0 0 0 0 0 0 0 0 0 0 0 0 0 0 0 0 0 0 0 0 0
0 0 1 2 17 18 19 20 17 18 19 20 17 18 19 20 17 18 19 20 17 18 19 20 17 18 19 20 17 18 19 20 17 18 19 20 17 18 19 20 17 18 19 20 17 18 0 0
0 0 1 2 0 0 1 2 0 0 1 2 0 0 1 2 0 0 1 2 0 0 1 2 0 0 1 2 0 0 1 2 0 0 1 2 0 0 1 2 0 0 1 2 0 0 0 0
0 0 1 2 10 11 1 2 10 11 1 2 10 11 1 2 10 11 1 2 10 11 1 2 10 11 1 2 10 11 1 2 10 11 1 2 10 11 1 2 10 11 1 2 10 11 0 0
0 0 1 2 5 6 1 2 5 6 1 2 5 6 1 2 5 6 1 2 5 6 1 2 5 6 1 2 5 6 1 2 5 6 1 2 5 6 1 2 5 6 1 2 5 6 0 0
0 0 1 2 21 22 1 2 4 4 1 2 21 22 1 2 21 22 1 2 8 9 1 2 4 4 1 2 21 22 1 2 4 4 1 2 21 22 1 2 4 4 1 2 21 22 0 0
0 0 1 2 23 24 1 2 4 4 1 2 23 24 1 2 23 24 1 2 12 13 1 2 4 4 1 2 23 24 1 2 4 4 1 2 23 24 1 2 4 4 1 2 23 24 0 0