32  11
49 50 23 136 137 8 49 50 8 8 8 8 49 50 8 8 49 50 8 8 11 12 23 136 137 8 8 8 11 12 105 106 
11 12 23 23 136 137 11 25 8 8 8 8 11 25 8 8 11 12 8 8 11 12 23 23 136 137 8 8 11 12 105 106 
11 12 23 23 23 136 24 25 8 8 8 8 24 25 8 8 11 12 8 8 11 12 23 23 23 136 137 8 11 12 105 106
11 25 23 23 23 23 8 8 8 8 8 8 11 25 8 8 11 12 8 8 11 12 23 23 23 23 136 137 11 12 105 106 
24 25 23 23 23 23 49 138 8 8 8 8 24 25 8 8 11 12 8 8 11 12 23 23 23 23 23 136 11 12 105 106 
8 8 8 8 8 8 8 8 8 8 8 8 8 8 8 8 8 8 8 8 8 8 8 8 8 8 8 8 8 139 105 106
49 50 140 141 140 141 49 50 142 143 140 141 49 50 8 8 49 50 8 8 49 50 140 141 140 141 140 141 49 144 105 106 
11 25 8 8 8 8 11 25 145 146 147 147 11 12 8 148 11 12 8 148 11 12 147 147 8 148 8 8 11 12 8 8 
24 25 8 8 8 8 24 25 8 8 147 147 11 12 149 150 11 12 149 150 11 12 147 147 149 150 8 8 11 12 140 141 
151 152 151 152 151 152 151 152 151 152 151 152 151 152 151 152 151 152 151 152 151 152 151 152 151 152 151 152 8 8 151 152 
153 154 153 154 153 154 153 154 153 154 153 154 153 154 153 154 153 154 153 154 153 154 153 154 153 154 153 154 49 50 153 154