48 11
0 0 1 2 1 2 1 2 1 2 1 2 1 2 1 2 3 3 0 0 4 5 0 0 4 5 0 0 4 5 0 0 4 5 0 0 4 5 0 0 3 3 6 3 3 3 0 0
0 0 7 8 9 10 7 8 9 10 7 8 9 10 7 8 11 12 0 0 4 5 0 0 4 5 0 0 4 5 0 0 4 5 0 0 4 5 0 0 13 6 11 12 14 15 0 0
0 0 0 0 4 5 0 0 4 5 0 0 4 5 0 0 0 0 0 0 0 0 0 0 0 0 0 0 0 0 0 0 0 0 0 0 0 0 0 0 0 0 0 0 0 0 0 0
0 0 16 16 4 5 16 16 4 5 16 16 4 5 0 0 3 3 7 8 9 10 7 8 9 10 7 8 9 10 7 8 9 10 7 8 9 10 7 8 4 5 3 3 3 3 17 18
0 0 16 16 4 5 16 16 4 5 16 16 4 5 0 0 3 3 0 0 4 5 0 0 4 5 0 0 4 5 0 0 4 5 0 0 4 5 0 0 4 5 3 3 3 3 19 20
0 0 16 16 4 5 16 16 4 5 21 22 0 0 3 3 23 24 0 0 4 5 0 0 4 5 0 0 4 5 0 0 4 5 16 16 4 5 16 16 4 5 3 3 11 12 14 15
0 0 16 16 4 5 16 16 4 5 22 3 3 3 3 3 11 12 0 0 4 5 0 0 4 5 0 0 4 5 0 0 4 5 16 16 4 5 16 16 4 5 3 3 0 0 0 0
0 0 16 25 4 5 16 25 0 0 11 12 14 15 14 15 11 12 0 0 4 5 0 0 4 5 0 0 4 5 0 0 4 5 16 16 4 5 16 16 4 5 0 0 0 0 0 0
0 0 0 0 0 0 0 0 0 0 0 0 0 0 0 0 0 0 0 0 0 0 0 0 0 0 0 0 0 0 0 0 4 5 16 16 4 5 16 16 4 5 0 0 0 0 0 0
0 0 26 27 26 27 26 27 26 27 26 27 26 27 26 27 26 27 26 27 26 27 26 27 26 27 26 27 26 27 0 0 4 5 16 25 4 5 16 25 4 5 0 0 0 0 0 0
0 0 28 29 28 29 28 29 28 29 28 29 28 29 28 29 28 29 28 29 28 29 28 29 28 29 28 29 28 29 0 0 0 0 0 0 0 0 0 0 0 0 0 0 0 0 0 0