16 11
0 1 2 3 1 4 4 4 5 1 6 7 2 3 0 0
0 1 2 3 1 4 8 5 1 4 9 10 11 3 0 0
0 1 2 3 1 4 5 1 4 4 12 13 14 3 0 0
0 0 15 3 16 5 17 7 18 19 4 4 2 3 0 0
0 0 0 0 0 0 0 0 0 0 1 4 2 3 0 0
0 0 15 3 20 10 21 4 4 4 4 4 2 3 0 0
0 0 15 3 22 13 23 4 4 4 24 25 0 0 0 0
0 26 2 3 1 4 4 4 8 5 1 4 27 28 29 0
0 30 15 3 1 4 4 4 5 1 4 4 6 7 29 0 
0 31 15 3 17 7 8 5 32 19 18 19 6 7 29 0
0 0 0 0 0 0 0 0 0 0 0 0 0 0 0 0 