48  10
8 23 23 23 23 23 11 12 23 23 23 23 23 23 23 23 24 25 23 23 24 25 23 23 23 23 23 23 23 23 8 8 9 10 9 10 11 12 20 21 9 10 11 12 17 18 9 10
8 23 23 47 23 23 11 25 23 23 48 23 48 23 48 23 11 25 23 47 11 12 23 23 23 23 48 23 48 23 23 8 42 43 36 37 11 12 42 43 42 43 11 12 19 19 42 43
8 23 65 66 23 23 24 25 23 23 23 23 23 23 23 23 24 25 65 66 11 12 23 23 23 23 23 23 23 23 23 8 9 10 20 21 11 12 9 10 9 10 11 12 19 19 9 10
8 23 23 23 23 23 76 77 23 23 23 23 85 86 85 86 11 12 85 86 11 12 23 23 23 47 23 23 23 23 23 8 78 79 80 80 80 80 81 82 83 84 11 12 19 19 42 43
8 8 8 8 8 8 8 8 23 23 23 23 8 96 8 96 11 12 8 96 11 12 23 23 65 66 8 8 8 8 8 8 8 8 8 8 8 8 8 93 94 95 11 12 19 19 9 10
8 23 85 86 85 86 11 12 23 23 80 104 23 23 85 86 8 8 8 8 8 8 23 23 80 104 23 23 23 47 105 106 15 44 42 43 49 50 100 101 93 102 80 80 78 79 80 80
8 23 8 96 8 96 11 12 8 8 8 8 112 113 8 96 8 8 8 8 49 50 8 8 8 93 104 23 65 66 105 106 13 14 9 10 11 12 26 27 8 8 8 8 8 8 8 8
8 23 23 23 23 23 11 25 85 86 11 12 93 104 23 23 8 8 8 8 11 25 85 86 11 12 93 104 23 23 105 106 45 46 42 43 11 12 42 43 40 41 11 12 36 37 11 12
8 23 23 23 23 23 24 25 8 96 11 12 129 93 112 113 8 8 8 8 24 25 8 96 11 12 129 93 104 23 105 106 63 64 9 10 11 12 9 10 17 18 11 12 20 21 11 12
8 23 80 104 23 23 76 77 23 23 76 77 23 132 93 133 8 8 8 8 76 77 80 104 76 77 23 129 93 133 105 106 78 79 78 79 76 77 78 79 78 79 76 77 78 79 76 77