48 11
0 0 0 0 0 0 1 2 0 0 0 0 3 4 5 6 5 6 5 6 5 6 5 6 5 6 5 6 5 6 5 6 5 6 5 6 5 6 5 6 5 6 5 6 5 6 0 0
0 0 0 0 0 0 7 7 0 0 0 0 3 4 8 9 8 9 10 11 12 13 10 11 14 15 10 11 14 15 10 11 14 15 10 11 14 15 10 11 14 15 10 11 16 16 0 0
0 0 0 0 17 18 7 7 17 18 0 0 3 4 5 6 5 6 0 0 3 4 0 0 3 4 0 0 3 4 0 0 3 4 0 0 3 4 0 0 3 4 0 0 16 16 0 0
0 0 0 0 19 20 7 7 19 20 0 0 3 4 16 16 16 16 21 22 3 4 21 22 3 4 21 22 3 4 21 22 3 4 21 22 3 4 21 22 3 4 21 22 16 16 0 0
0 0 17 18 19 20 7 7 19 20 17 18 3 4 16 16 16 16 23 24 3 4 23 24 3 4 23 24 3 4 23 24 3 4 23 24 3 4 23 24 3 4 23 24 16 16 0 0
0 25 19 20 19 20 0 0 19 20 19 20 3 4 16 16 16 16 26 24 3 4 26 24 3 4 26 24 3 4 26 24 3 4 26 24 3 4 26 24 3 4 26 24 16 16 0 0
0 27 19 20 19 20 0 0 19 20 19 20 3 4 16 16 16 16 23 24 3 4 23 24 3 4 23 24 3 4 23 24 3 4 23 24 3 4 23 24 3 4 23 24 16 16 0 0
0 28 29 30 29 30 31 32 29 30 29 30 3 4 0 0 0 0 0 0 0 0 0 0 0 0 0 0 0 0 0 0 0 0 0 0 0 0 0 0 0 0 0 0 16 16 0 0
0 0 0 0 0 0 0 0 0 0 0 0 0 0 16 16 16 16 16 16 16 16 16 16 16 16 16 16 16 16 16 16 16 16 16 16 16 16 16 16 16 16 16 16 33 0 0 0
8 9 8 9 8 9 8 9 8 9 8 9 8 9 8 9 8 9 10 11 14 15 10 11 14 15 10 11 14 15 10 11 14 15 10 11 14 15 10 11 14 15 34 35 16 16 0 0
5 6 5 6 5 6 5 6 5 6 5 6 5 6 5 6 5 6 0 0 3 4 0 0 3 4 0 0 3 4 0 0 3 4 0 0 3 4 0 0 3 4 35 16 16 16 0 0