48 12
0 0 1 2 0 0 1 2 0 0 1 2 0 0 1 2 3 0 4 5 6 7 1 2 0 0 6 7 4 5 0 0 1 2 0 0 4 5 1 2 0 0 0 0 4 5 3 3
0 0 1 2 0 0 1 2 0 0 1 2 0 0 1 2 3 8 9 10 0 0 1 2 11 8 12 13 0 0 0 0 1 2 12 13 0 0 1 2 11 8 12 13 0 0 3 3
0 0 1 2 0 0 1 2 0 0 1 2 0 0 1 2 3 14 6 7 0 0 1 2 15 16 4 5 0 0 0 0 1 2 4 5 0 0 1 2 15 16 4 5 0 0 3 3
17 18 1 2 15 16 1 2 15 16 1 2 17 18 1 2 3 19 0 0 12 13 1 2 15 16 0 0 17 18 17 18 1 2 9 10 0 0 1 2 15 16 17 18 0 0 3 3
3 3 3 3 3 3 3 3 3 3 3 3 3 3 3 3 3 3 0 0 4 5 3 3 3 3 0 0 3 3 3 3 3 3 6 7 0 0 3 3 3 3 3 3 0 0 3 3
20 21 22 23 20 21 22 23 20 21 22 23 20 21 3 3 3 0 0 0 15 16 1 2 3 3 0 0 0 0 3 3 3 0 17 18 11 8 3 3 9 10 11 8 0 0 3 3
3 3 1 2 3 3 1 2 3 3 1 2 3 3 3 3 3 0 0 0 3 3 1 2 3 3 0 0 0 0 3 3 3 0 3 3 15 16 3 3 6 7 15 16 24 3 3 3
12 13 1 2 12 13 1 2 12 13 1 2 12 13 3 3 3 0 12 13 9 10 1 2 3 3 0 0 12 13 3 3 3 0 0 0 15 16 3 3 0 0 25 26 1 2 3 3
4 5 1 2 4 5 1 2 4 5 1 2 4 5 3 3 3 0 4 5 6 7 1 2 3 3 0 0 4 5 3 3 3 0 0 0 3 3 3 3 0 0 26 0 1 2 3 3
0 0 1 2 9 10 1 2 0 0 1 2 9 10 3 3 3 0 11 8 0 0 1 2 3 3 0 0 0 0 3 3 3 0 0 0 0 0 0 0 25 26 0 0 1 2 3 3
0 0 1 2 6 7 1 2 0 0 1 2 6 7 3 3 3 0 15 16 0 0 1 2 3 3 0 0 0 0 3 3 3 0 0 0 0 0 0 0 26 0 0 0 1 2 3 3
3 3 3 3 3 3 3 3 3 3 3 3 3 3 3 3 3 3 3 3 3 3 3 3 3 3 3 3 3 3 3 3 3 3 3 3 3 3 3 3 3 3 3 3 3 3 3 3